11111111111111111111111111111111111111111111111111111111111111111111111111111
10000000000000000000000000000000000000000000000000000000000000000000000000001
10000C0000000000000000000000000000000000C00000000C0000000000000000000C0000001
100000C0000000000000000000000000000C000C0000000000C00000000000000000C00000001
1000000C00000011111111111111111100000000000000C0C000000000000C000000000000001
10000000C0000000000000000000000000000C00000000000000C0000000000000C0000000001
100000000C0000000000000000000000001111111111111111111111111111111111100000001
1000000000C000000000000000000000000C00000C000000000000C000000000C000000000001
10000000000C0000000000000000000000C00000000000000000000C0000000C0000000000001
100000000000C00000000000000000011111111111111111100C00000000000000000000P0001
1000000000000C000000000000000000C000000000C00000000000000C000C000000000000001
10000000000000C0000000000000000C00000000000C00000000000000C0C0000000000000001
100000000000000C00000000000000C0000000000000C0000000000000CC00000000000000001
1000000000000000C0001111111111111111110000C000000000000000C000000001111111001
10000000000000000C0000000000C00000000000000000C000000000C0000C000000000000001
100000000000000000C00000000C00000000111111111111111111000C000000C000000000001
1000000000000000000C000000C000000000000000000000C00000C00000000C0000000000001
1000000001111111111111111110000000000C00011111111111111111100000000000000C001
100000000000000000000C00C00000000000000000000000C000C000000000000C00000000001
1000000000000000000000CC0000000000000000000000000C0C00000000000000C000E000001
10000000000000000000000000000000000000000000000000000000000000000000000000001
11111111111111111111111111111111111111111111111111111111111111111111111111111