1111111111111111111111111111111111
1ECCCCCCCCCCCCCCCCCCCCCCCCCCCCCCC1
1010010100100000101001000000010101
1110010010101010001001000000010101
1PCC1CCCCCCCCCCCCCCCCCCCCCCCCCCCC1
1111111111111111111111111111111111